{
    "width": 48,
    "height": 48,
    "minplayers": 1,
    "maxplayers": 10,
    "teamcount": 2,
    "tilesize" : 16,
    "teams": [
        {
            "spawns": [
                {"x":0,"y":0},
                {"x":0,"y":5}
            ],
            "base": {"x":23,"y":0}
        },
        {
            "spawns": [
                {"x":3,"y":3},
                {"x":3,"y":5}
            ],
            "base": {"x":23,"y":46}
        }
    ],
    "tiles":[
        [0,0,0,0,0,0,0,0,3,3,0,0,0,0,0,0,0,0,3,3,0,0,0,0,0,0,0,0,0,0,5,5,0,0,5,5,5,5,0,0,0,0,0,0,0,0,0,0],
        [0,0,0,0,0,0,0,0,3,3,0,0,0,0,0,0,0,0,3,3,0,0,0,0,0,0,0,0,0,0,5,5,0,0,5,5,0,0,0,0,0,0,0,0,0,0,0,0],
        [0,0,2,2,0,0,0,0,0,0,2,2,0,0,0,0,2,2,3,3,3,3,0,0,0,0,0,0,0,0,1,1,0,0,1,1,3,3,0,0,1,1,1,1,1,1,1,0],
        [0,0,2,2,0,0,0,0,0,0,2,2,0,0,0,0,2,2,3,3,3,3,0,0,0,0,0,0,0,0,1,1,0,0,1,1,3,3,0,0,0,0,1,1,1,1,1,0],
        [0,0,0,0,2,2,0,0,0,0,0,0,0,0,2,2,3,3,0,0,2,0,0,0,0,0,0,0,3,3,3,3,0,0,1,1,3,3,0,1,1,0,0,0,0,0,0,0],
        [0,0,0,0,2,2,0,0,0,0,0,0,0,0,2,2,3,3,2,2,2,0,0,0,0,0,0,0,3,3,3,3,0,0,1,1,3,3,0,1,1,0,0,0,0,0,0,0],
        [0,0,0,0,0,0,2,2,0,0,3,3,3,3,3,3,3,3,3,3,0,0,0,2,0,0,3,3,3,3,3,3,3,3,3,3,3,3,1,1,1,1,1,1,0,0,0,0],
        [0,0,0,0,0,0,2,2,0,0,3,3,3,3,3,3,3,3,3,3,0,0,0,2,0,0,3,3,3,3,3,3,3,3,3,3,3,3,1,1,1,1,1,1,0,0,0,0],
        [0,0,2,0,0,0,0,0,2,2,3,3,3,3,2,2,3,3,0,0,0,0,2,2,0,0,0,0,0,0,3,3,3,3,0,0,0,0,2,2,1,1,0,0,0,1,1,0],
        [0,0,2,0,0,0,0,0,2,2,3,3,3,3,2,2,3,3,0,0,0,0,2,2,0,0,0,0,0,0,3,3,3,3,1,1,1,1,0,0,1,1,0,0,0,1,1,0],
        [0,0,2,2,2,0,3,3,0,0,2,2,3,3,3,3,2,2,0,0,0,0,0,2,0,0,1,1,2,2,0,0,0,0,1,1,1,1,0,0,0,0,0,0,1,1,1,0],
        [0,0,0,0,2,0,3,3,0,0,2,2,3,3,3,3,2,2,0,0,0,0,0,2,0,0,1,1,0,0,0,0,1,1,0,0,0,0,0,0,0,0,0,0,1,1,0,0],
        [0,0,0,0,3,3,3,3,3,3,3,3,3,3,0,0,0,0,2,2,0,0,0,0,0,0,0,1,0,0,0,0,1,1,5,5,5,5,5,5,5,5,5,5,5,5,5,5],
        [0,0,0,0,3,3,3,3,3,3,3,3,3,3,0,0,0,0,2,2,0,0,0,0,0,0,0,1,0,0,1,1,1,1,5,5,5,5,5,5,5,5,5,5,5,5,5,5],
        [0,0,0,0,2,0,3,3,0,0,2,2,3,3,0,0,0,0,0,0,2,2,0,0,0,0,0,1,0,0,1,1,0,0,5,5,5,5,5,5,5,5,5,5,5,5,5,5],
        [0,0,2,2,2,0,3,3,0,0,2,2,3,3,0,0,0,0,0,0,2,2,0,0,0,0,0,1,0,0,0,0,0,0,5,5,5,5,5,5,5,5,5,5,5,5,5,5],
        [0,0,3,3,3,3,3,3,2,2,0,0,2,2,0,0,0,0,0,0,0,0,2,2,0,0,0,0,0,0,2,2,0,0,5,5,5,5,5,5,5,5,5,5,5,5,5,5],
        [0,0,3,3,3,3,3,3,2,2,0,0,2,2,0,0,2,2,0,0,0,0,2,2,0,0,0,0,0,0,2,2,0,0,5,5,5,5,5,5,5,5,5,5,5,5,5,5],
        [0,0,3,3,3,3,2,2,0,0,0,0,0,0,0,0,0,2,0,0,0,0,0,0,0,0,1,1,0,0,1,1,0,0,5,5,5,5,5,5,5,5,5,5,5,5,5,5],
        [0,0,3,3,3,3,2,2,0,0,0,0,0,0,0,0,0,2,0,0,0,0,0,0,0,0,1,1,0,0,1,1,0,0,5,5,5,5,5,5,5,5,5,5,5,5,5,5],
        [0,0,0,0,2,2,0,0,0,0,0,0,0,0,0,0,0,0,0,0,0,0,0,2,2,2,0,1,0,0,1,1,0,0,5,5,5,5,5,5,5,5,5,5,5,0,0,0],
        [0,0,0,0,2,2,0,0,0,0,0,0,0,0,0,0,0,0,0,0,2,0,0,2,2,2,0,1,0,0,1,1,0,0,5,5,5,5,5,5,5,5,5,5,0,0,0,0],
        [1,1,1,0,0,0,0,0,0,0,0,0,0,0,0,0,0,0,2,2,2,0,0,0,0,0,0,1,0,0,1,1,0,0,0,0,0,0,0,0,0,0,5,5,0,1,1,1],
        [0,0,1,0,0,0,0,0,0,0,0,1,1,1,1,0,0,0,0,0,0,0,0,0,0,0,0,1,0,0,1,1,0,0,0,0,0,1,1,1,1,0,5,5,0,1,5,5],
        [0,0,1,0,0,0,0,0,0,0,0,1,0,0,1,0,0,0,0,0,0,0,0,0,0,0,0,0,0,0,1,1,0,0,0,0,0,1,0,0,1,0,0,0,0,1,5,5],
        [1,1,1,0,2,2,0,0,0,0,0,1,0,0,1,0,0,0,0,0,0,0,0,0,0,0,0,0,0,0,0,0,0,0,0,0,0,1,0,0,1,0,0,0,0,1,1,1],
        [0,0,0,0,0,0,0,0,0,0,0,0,0,0,0,0,0,0,0,0,0,0,0,0,0,0,1,1,0,0,1,1,0,0,0,0,0,1,0,0,1,0,0,0,0,0,0,0],
        [0,0,0,0,0,0,0,0,0,0,0,0,0,0,0,0,0,0,0,0,0,0,0,0,0,0,1,1,0,0,1,1,0,0,0,0,0,1,0,0,1,0,0,0,1,0,0,0],
        [0,0,0,0,0,0,0,0,0,0,0,0,0,0,0,0,0,0,0,0,0,0,0,0,0,0,1,1,0,0,1,1,1,1,0,0,0,1,1,1,1,0,0,0,1,1,2,2],
        [0,0,0,0,0,0,0,0,0,0,1,1,1,1,0,0,0,0,0,0,2,2,0,0,0,0,1,1,0,0,1,1,1,1,0,0,0,0,0,0,0,0,0,0,1,1,2,2],
        [0,0,0,0,0,0,0,0,0,0,3,3,3,3,0,0,0,0,0,0,3,3,0,0,0,0,0,0,0,0,0,0,1,1,0,0,1,1,1,1,2,2,0,0,2,2,0,0],
        [0,0,2,2,2,2,0,0,1,1,3,3,3,3,2,2,0,0,1,1,3,3,1,1,0,0,0,0,0,0,0,0,1,1,0,0,1,1,1,1,2,2,0,0,2,2,0,0],
        [0,0,3,3,3,3,0,0,3,3,3,3,3,3,3,3,0,0,3,3,3,3,3,3,0,0,0,0,1,1,0,0,0,0,0,0,1,1,2,2,0,0,0,0,0,0,0,0],
        [0,0,3,3,3,3,1,1,3,3,3,3,3,3,3,3,1,1,3,3,3,3,3,3,1,1,0,0,1,1,0,0,0,0,0,0,1,1,2,2,0,0,0,0,0,0,0,0],
        [3,3,3,3,3,3,3,3,3,3,3,3,3,3,3,3,3,3,3,3,3,3,3,3,3,3,0,0,2,2,1,1,1,1,0,0,1,1,1,1,0,0,1,1,1,1,0,0],
        [3,3,3,3,3,3,3,3,3,3,3,3,3,3,3,3,3,3,3,3,3,3,3,3,3,3,0,0,2,2,1,1,1,1,0,0,1,1,1,1,0,0,1,1,1,1,0,0],
        [3,3,3,3,4,4,3,3,3,3,3,3,3,3,3,3,4,4,3,3,3,3,3,3,3,3,0,0,0,0,1,1,1,1,0,0,1,1,0,0,0,0,0,0,1,1,2,2],
        [3,3,3,3,4,4,3,3,3,3,3,3,3,3,3,3,4,4,3,3,3,3,3,3,3,3,0,0,0,0,1,1,1,1,0,0,1,1,0,0,0,0,0,0,1,1,2,2],
        [3,3,3,3,4,4,4,4,4,4,3,3,3,3,3,3,4,4,4,4,4,4,3,3,3,3,2,2,0,0,2,2,0,0,0,0,1,1,0,0,2,2,0,0,0,0,2,2],
        [3,3,3,3,4,4,4,4,4,4,3,3,3,3,3,3,4,4,4,4,4,4,3,3,3,3,2,2,0,0,2,2,0,0,0,0,1,1,0,0,2,2,0,0,0,0,2,2],
        [3,3,3,3,3,3,3,3,4,4,3,3,2,2,3,3,3,3,3,3,4,4,3,3,3,3,0,0,0,0,2,2,0,0,1,1,0,0,0,0,1,1,1,1,0,0,1,1],
        [3,3,3,3,3,3,3,3,4,4,3,3,2,2,3,3,3,3,3,3,4,4,3,3,3,3,0,0,0,0,2,2,0,0,1,1,0,0,0,0,1,1,1,1,0,0,1,1],
        [3,3,3,3,3,3,3,3,3,3,3,3,3,3,3,3,3,3,3,3,3,3,3,3,3,3,0,0,0,0,0,0,0,0,1,1,1,1,0,0,1,1,1,1,0,0,2,2],
        [3,3,3,3,3,3,3,3,3,3,3,3,3,3,3,3,3,3,3,3,3,3,3,3,3,3,0,0,0,0,0,0,0,0,1,1,1,1,0,0,1,1,1,1,0,0,2,2],
        [3,3,3,3,3,3,3,3,3,3,1,1,1,1,3,3,3,3,3,3,3,3,3,3,2,2,0,0,1,1,0,0,0,0,0,0,1,1,0,0,2,2,1,1,0,0,0,0],
        [3,3,3,3,3,3,3,3,3,3,0,0,0,0,3,3,3,3,3,3,3,3,3,3,0,0,0,0,1,1,0,0,0,0,0,0,1,1,0,0,2,2,1,1,0,0,0,0],
        [3,3,3,3,3,3,3,3,1,1,0,0,0,0,1,1,3,3,3,3,3,3,2,2,0,0,0,0,1,1,0,0,1,1,0,0,0,0,2,2,0,0,0,0,2,2,0,0],
        [0,0,3,3,3,3,3,3,0,0,0,0,0,0,0,0,3,3,3,3,3,3,0,0,0,0,0,0,1,1,0,0,1,1,0,0,0,0,2,2,0,0,0,0,2,2,0,0],
        [0,0,2,2,1,1,1,1,0,0,0,1,1,1,1,0,1,1,1,1,1,1,0,0,0,0,0,0,1,1,0,0,1,1,0,0,0,0,0,0,0,0,0,0,2,2,0,0]]
}