{
    "width": 48,
    "minplayers": 1,
    "maxplayers": 10,
    "teamcount": 2,
    "height": 48,
    "tilesize" : 16,
    "spawns": [
        [[0,0,1],[0,0,1]],
        [[0,3,1],[0,0,1]]
    ],
    "base": [
        [23,0],
        [23,46]
    ],
    "tiles":[
        [0,0,0,0,0,0,0,0,3,3,0,0,0,0,0,0,0,0,3,3,0,0,0,0,0,0,0,0,0,0,5,5,0,0,5,5,5,5,0,0,0,0,0,0,0,0,0,0],
        [0,0,0,0,0,0,0,0,3,3,0,0,0,0,0,0,0,0,3,3,0,0,0,0,0,0,0,0,0,0,5,5,0,0,5,5,0,0,0,0,0,0,0,0,0,0,0,0],
        [0,0,2,2,0,0,0,0,0,0,2,2,0,0,0,0,2,2,3,3,3,3,0,0,0,0,0,0,0,0,1,1,0,0,1,1,3,3,0,0,1,1,1,1,1,1,1,0],
        [0,0,2,2,0,0,0,0,0,0,2,2,0,0,0,0,2,2,3,3,3,3,0,0,0,0,0,0,0,0,1,1,0,0,1,1,3,3,0,0,0,0,1,1,1,1,1,0],
        [0,0,0,0,2,2,0,0,0,0,0,0,0,0,2,2,3,3,0,0,2,0,0,0,0,0,0,0,3,3,3,3,0,0,1,1,3,3,0,1,1,0,0,0,0,0,0,0],
        [0,0,0,0,2,2,0,0,0,0,0,0,0,0,2,2,3,3,2,2,2,0,0,0,0,0,0,0,3,3,3,3,0,0,1,1,3,3,0,1,1,0,0,0,0,0,0,0],
        [0,0,0,0,0,0,2,2,0,0,3,3,3,3,3,3,3,3,3,3,0,0,0,2,0,0,3,3,3,3,3,3,3,3,3,3,3,3,1,1,1,1,1,1,0,0,0,0],
        [0,0,0,0,0,0,2,2,0,0,3,3,3,3,3,3,3,3,3,3,0,0,0,2,0,0,3,3,3,3,3,3,3,3,3,3,3,3,1,1,1,1,1,1,0,0,0,0],
        [0,0,2,0,0,0,0,0,2,2,3,3,3,3,2,2,3,3,0,0,0,0,2,2,0,0,0,0,0,0,3,3,3,3,0,0,0,0,2,2,1,1,0,0,0,1,1,0],
        [0,0,2,0,0,0,0,0,2,2,3,3,3,3,2,2,3,3,0,0,0,0,2,2,0,0,0,0,0,0,3,3,3,3,1,1,1,1,0,0,1,1,0,0,0,1,1,0],
        [0,0,2,2,2,0,3,3,0,0,2,2,3,3,3,3,2,2,0,0,0,0,0,2,0,0,1,1,2,2,0,0,0,0,1,1,1,1,0,0,0,0,0,0,1,1,1,0],
        [0,0,0,0,2,0,3,3,0,0,2,2,3,3,3,3,2,2,0,0,0,0,0,2,0,0,1,1,0,0,0,0,1,1,0,0,0,0,0,0,0,0,0,0,1,1,0,0],
        [0,0,0,0,3,3,3,3,3,3,3,3,3,3,0,0,0,0,2,2,0,0,0,0,0,0,0,1,0,0,0,0,1,1,5,5,5,5,5,5,5,5,5,5,5,5,5,5],
        [0,0,0,0,3,3,3,3,3,3,3,3,3,3,0,0,0,0,2,2,0,0,0,0,0,0,0,1,0,0,1,1,1,1,5,5,5,5,5,5,5,5,5,5,5,5,5,5],
        [0,0,0,0,2,0,3,3,0,0,2,2,3,3,0,0,0,0,0,0,2,2,0,0,0,0,0,1,0,0,1,1,0,0,5,5,5,5,5,5,5,5,5,5,5,5,5,5],
        [0,0,2,2,2,0,3,3,0,0,2,2,3,3,0,0,0,0,0,0,2,2,0,0,0,0,0,1,0,0,0,0,0,0,5,5,5,5,5,5,5,5,5,5,5,5,5,5],
        [0,0,3,3,3,3,3,3,2,2,0,0,2,2,0,0,0,0,0,0,0,0,2,2,0,0,0,0,0,0,2,2,0,0,5,5,5,5,5,5,5,5,5,5,5,5,5,5],
        [0,0,3,3,3,3,3,3,2,2,0,0,2,2,0,0,2,2,0,0,0,0,2,2,0,0,0,0,0,0,2,2,0,0,5,5,5,5,5,5,5,5,5,5,5,5,5,5],
        [0,0,3,3,3,3,2,2,0,0,0,0,0,0,0,0,0,2,0,0,0,0,0,0,0,0,1,1,0,0,1,1,0,0,5,5,5,5,5,5,5,5,5,5,5,5,5,5],
        [0,0,3,3,3,3,2,2,0,0,0,0,0,0,0,0,0,2,0,0,0,0,0,0,0,0,1,1,0,0,1,1,0,0,5,5,5,5,5,5,5,5,5,5,5,5,5,5],
        [0,0,0,0,2,2,0,0,0,0,0,0,0,0,0,0,0,0,0,0,0,0,0,2,2,2,0,1,0,0,1,1,0,0,5,5,5,5,5,5,5,5,5,5,5,5,5,5],
        [0,0,0,0,2,2,0,0,0,0,0,0,0,0,0,0,0,0,0,0,2,0,0,2,2,2,0,1,0,0,1,1,0,0,5,5,5,5,5,5,5,5,5,5,5,5,5,5],
        [1,1,1,0,0,0,0,0,0,0,0,0,0,0,0,0,0,0,2,2,2,0,0,0,0,0,0,1,0,0,1,1,0,0,0,0,0,0,0,0,0,0,5,5,5,1,1,1],
        [0,0,1,0,0,0,0,0,0,0,0,1,1,1,1,0,0,0,0,0,0,0,0,0,0,0,0,1,0,0,1,1,0,0,0,0,0,1,1,1,1,0,5,5,5,1,5,5],
        [0,0,1,0,0,0,0,0,0,0,0,1,0,0,1,0,0,0,0,0,0,0,0,0,0,0,0,0,0,0,1,1,0,0,0,0,0,1,0,0,1,0,0,0,5,1,5,5],
        [1,1,1,0,2,2,0,0,0,0,0,1,0,0,1,0,0,0,0,0,0,0,0,0,0,0,0,0,0,0,0,0,0,0,0,0,0,1,0,0,1,0,0,0,5,1,1,1],
        [0,0,0,0,0,0,0,0,0,0,0,0,0,0,0,0,0,0,0,0,0,0,0,0,0,0,1,1,0,0,1,1,0,0,0,0,0,1,0,0,1,0,0,0,5,5,5,5],
        [0,0,0,0,0,0,0,0,0,0,0,0,0,0,0,0,0,0,0,0,0,0,0,0,0,0,1,1,0,0,1,1,0,0,0,0,0,1,0,0,1,0,0,0,1,1,1,1],
        [0,0,0,0,0,0,0,0,0,0,0,0,0,0,0,0,0,0,0,0,0,0,0,0,0,0,1,1,0,0,1,1,1,1,0,0,0,1,1,1,1,0,0,0,1,1,2,2],
        [0,0,0,0,0,0,0,0,0,0,1,1,1,1,0,0,0,0,0,0,2,2,0,0,0,0,1,1,0,0,1,1,1,1,0,0,0,0,0,0,0,0,0,0,1,1,2,2],
        [0,0,0,0,0,0,0,0,0,0,3,3,3,3,0,0,0,0,0,0,3,3,0,0,0,0,0,0,0,0,0,0,1,1,0,0,1,1,1,1,2,2,0,0,2,2,0,0],
        [0,0,2,2,2,2,0,0,1,1,3,3,3,3,2,2,0,0,1,1,3,3,1,1,0,0,0,0,0,0,0,0,1,1,0,0,1,1,1,1,2,2,0,0,2,2,0,0],
        [0,0,3,3,3,3,0,0,3,3,3,3,3,3,3,3,0,0,3,3,3,3,3,3,0,0,0,0,1,1,0,0,0,0,0,0,1,1,2,2,0,0,0,0,0,0,0,0],
        [0,0,3,3,3,3,1,1,3,3,3,3,3,3,3,3,1,1,3,3,3,3,3,3,1,1,0,0,1,1,0,0,0,0,0,0,1,1,2,2,0,0,0,0,0,0,0,0],
        [3,3,3,3,3,3,3,3,3,3,3,3,3,3,3,3,3,3,3,3,3,3,3,3,3,3,0,0,2,2,1,1,1,1,0,0,1,1,1,1,0,0,1,1,1,1,0,0],
        [3,3,3,3,3,3,3,3,3,3,3,3,3,3,3,3,3,3,3,3,3,3,3,3,3,3,0,0,2,2,1,1,1,1,0,0,1,1,1,1,0,0,1,1,1,1,0,0],
        [3,3,3,3,4,4,3,3,3,3,3,3,3,3,3,3,4,4,3,3,3,3,3,3,3,3,0,0,0,0,1,1,1,1,0,0,1,1,0,0,0,0,0,0,1,1,2,2],
        [3,3,3,3,4,4,3,3,3,3,3,3,3,3,3,3,4,4,3,3,3,3,3,3,3,3,0,0,0,0,1,1,1,1,0,0,1,1,0,0,0,0,0,0,1,1,2,2],
        [3,3,3,3,4,4,4,4,4,4,3,3,3,3,3,3,4,4,4,4,4,4,3,3,3,3,2,2,0,0,2,2,0,0,0,0,1,1,0,0,2,2,0,0,0,0,2,2],
        [3,3,3,3,4,4,4,4,4,4,3,3,3,3,3,3,4,4,4,4,4,4,3,3,3,3,2,2,0,0,2,2,0,0,0,0,1,1,0,0,2,2,0,0,0,0,2,2],
        [3,3,3,3,3,3,3,3,4,4,3,3,2,2,3,3,3,3,3,3,4,4,3,3,3,3,0,0,0,0,2,2,0,0,1,1,0,0,0,0,1,1,1,1,0,0,1,1],
        [3,3,3,3,3,3,3,3,4,4,3,3,2,2,3,3,3,3,3,3,4,4,3,3,3,3,0,0,0,0,2,2,0,0,1,1,0,0,0,0,1,1,1,1,0,0,1,1],
        [3,3,3,3,3,3,3,3,3,3,3,3,3,3,3,3,3,3,3,3,3,3,3,3,3,3,0,0,0,0,0,0,0,0,1,1,1,1,0,0,1,1,1,1,0,0,2,2],
        [3,3,3,3,3,3,3,3,3,3,3,3,3,3,3,3,3,3,3,3,3,3,3,3,3,3,0,0,0,0,0,0,0,0,1,1,1,1,0,0,1,1,1,1,0,0,2,2],
        [3,3,3,3,3,3,3,3,3,3,1,1,1,1,3,3,3,3,3,3,3,3,3,3,2,2,0,0,1,1,0,0,0,0,0,0,1,1,0,0,2,2,1,1,0,0,0,0],
        [3,3,3,3,3,3,3,3,3,3,0,0,0,0,3,3,3,3,3,3,3,3,3,3,0,0,0,0,1,1,0,0,0,0,0,0,1,1,0,0,2,2,1,1,0,0,0,0],
        [3,3,3,3,3,3,3,3,1,1,0,0,0,0,1,1,3,3,3,3,3,3,2,2,0,0,0,0,1,1,0,0,1,1,0,0,0,0,2,2,0,0,0,0,2,2,0,0],
        [0,0,3,3,3,3,3,3,0,0,0,0,0,0,0,0,3,3,3,3,3,3,0,0,0,0,0,0,1,1,0,0,1,1,0,0,0,0,2,2,0,0,0,0,2,2,0,0],
        [0,0,2,2,1,1,1,1,0,0,0,1,1,1,1,0,1,1,1,1,1,1,0,0,0,0,0,0,1,1,0,0,1,1,0,0,0,0,0,0,0,0,0,0,2,2,0,0]]
}